- - - - - - - - - - - - - - - - - - -
- A + - + + + + + + - + + + + - + + -
- - + - + - + + + + - + + + + - + + -
- + + - + - - - - + - + - - - - + + -
- + - - + - + + + + - + + + + - + + -
- + + - + - + - + + - + + + + + + + -
- - + - + - + - - - - - - - - - - + -
- + + + + - + + + + - + + + + + - + -
- + - - - - + + + + - + - + + + - + -
- + - + + + + + + + - + - - - + - + -
- + - + + - + + + + - + - + + + - + -
- + - + + - + + + + - + - + - - - + -
- + - + + - + + + + - + + + + + + + -
- + - - - - + + - - + - - - - - - - -
- + + + + - + + - + + + + + + + + + -
- + + - + - + + - + + + + + + + + + -
- - + - + - - - - - - - - - - - - + -
- + + - + + + + + + + + + + + + + B -
- - - - - - - - - - - - - - - - - - -
