- - - - - - - -
- A - + + + + -
- + - + - - + -
- + - + - + + -
- + - + - - + -
- + + + - B + -
- - - - - - - -
