- - - - - -
- A + + + -
- - - - + -
- + + + + -
- + + - - -
- + + + B -
- - - - - -
