- - - - - - - -
- A + + + + + -
- - - + + + + -
- + - - - + + -
- + + + - - + -
- + + + + B + -
- - - - - - - -
