- - - - - -
- A + + + -
- + + + + -
- + + + + -
- + + + + -
- + + + B -
- - - - - -
